.#########.
.#.......#
.####.####
###.....###
#.###.###.#
#....@....#
#.###.###.#
###.....###
.####.####
.#.......#
.#########.
